5 10
|--------|
|.F.|..-.|
|..-|.@..|
|...F..-.|
|--------|